type octile
height 22
width 32
map
@@@@@@@@@@@@@@@@@@@@@@@@@@@@@@@@
@..............................@
@..............................@
@..............................@
@..............................@
@..............................@
@..............................@
@..............................@
@..............................@
@..............................@
@..............................@
@..............................@
@..............................@
@..............................@
@..............................@
@..............................@
@..............................@
@..............................@
@..............................@
@..............................@
@..............................@
@@@@@@@@@@@@@@@@@@@@@@@@@@@@@@@@